DDDDDDDDDDDDDXDDDXXXDDDXD
XXXDDXXXXXXDDXDXDXXXDDDDD
DDDDDDDDDDDDXXDXDDDDDXXXX
XDDXXXDDDXXXDDDDXDXDXXXXD
DDDDDDDXXXDDXDXDXDXDDDDDD
DDXXDDXXDDDXXDXDXXXDXDXXD
DDDDDDDDDDXXDDXDXDDDXXDXX
DXDXXDDXDXXXXDXDXDXDDDDDX
DDDDDDDDDDDDDDXDXDXXXDDDD
XXXXDDDXXXDDDXXXXDXDDDDDX
DDDDDDXXXXDXDDDDDDDXXXDXX
DDXXXXXXXXXXXXXXXDDDDXDDD
DDDDDDDDDDDDXXDDXXXDDXDXD
DDXXXXXXXDDXXXDDDDDDDXXDD
DDDDDDDDDDDXXXDDXXXXXDDDD
XXXXXXXDDXXXXDDDXXDDDXXDX
DDDDDDDDDXXXXDDDXXDDDXDDD
XXXXXXXDDXXXXDDDXXDXXXDDD
DDDDDDDDDDDDDDDDDDDDDXDDD
DXXXXXXDDXXXXXXXXXDDXXXDX